....##########
..X...##..####
............##
...@.........#
#
##......X
###........###