........#####
######..#...#
.....#..#.X.#
##.@.#..#...#
.#...####...#
.#.....X....#
.############