....#......##
.##....X....#
.#
...@#......##
...##..#....#
#......#...X.
##.....###...